# === ACTIVACIÓN DE ENTORNOS ===
alias 9807='cd ~/Gabo && source env/bin/activate && code .'
alias 0722='cd ~/Gabo/PROYECTOS_DE_CURSOS_PROGRAMACION && source env_local/bin/activate && code .'
alias web='cd ~/Gabo/PROYECTOS_DE_CURSOS_PROGRAMACION/CURSO_DE_DESARROLLO_WEB && source env_local/bin/activate && code .'

# === GIT FLUJO RÁPIDO ===
alias guardar="bash ~/Gabo/scripts/guardar_git.sh"
alias estado='git status'
alias añadir='git add -A'
alias mensaje='git commit -m'
alias subir='git push origin main'
alias historial='git log --oneline --graph --all --decorate'

# Limpieza de archivos ignorados o sucios
alias gitclean='git status --ignored --untracked-files=all | grep -E "^\s+[^ ]" || echo -e "\n✅ \033[1;32mTodo limpio. No hay archivos sucios.\033[0m"'

# === BÚSQUEDA RÁPIDA EN PROYECTOS ===
alias buscar='grep -RiIl'
alias buscar_python='grep -RiIl --include="*.py"'

# === ARCHIVOS Y CARPETAS ===
alias abrir='xdg-open'
alias limpiar='clear'
alias arriba='cd ..'
alias escritorio='cd ~/Escritorio'
alias proyectos='cd ~/Gabo/PROYECTOS_DE_CURSOS_PROGRAMACION'
alias listar='ls -lah --color'

# === COMPRESIÓN Y RESPALDOS ===
alias comprimir='tar -czvf'
alias descomprimir='tar -xzvf'
alias respaldo='bash ~/Gabo/scripts/respaldo_config.sh'

# === UTILIDADES ===
alias fecha='date "+%Y-%m-%d %H:%M:%S"'
alias reloj='watch -n 1 date'
alias cls='clear'
alias salir='exit'

# === ACTUALIZAR CONFIGURACIÓN ===
alias recargar_alias='source ~/.mis_aliases.sh && echo "✅ Alias recargados correctamente."'
alias recargar_todo='source ~/.zshrc && echo "✅ Zsh recargado correctamente."'